Wave1
-A--------------------A------------------
-------C------A-------------------------D
----------------------------------------D
------BB--------------------A------------
--A---------------------D----------------

Wave2
-A--------------------A------------------
-------C------A-------------------------D
----------------------------------------D
------BB--------------------A------------
--A---------------------D----------------

Wave3
-A--------------------A------------------
-------C------A-------------------------D
----------------------------------------D
------BB--------------------A------------
--A---------------------D----------------

InfosA
HP:10
Speed:60
Damage:60