Wave1
-A--------------------A------------------
-------C------A-------------------------D
----------------------------------------D
------BB--------------------A------------
--A---------------------D----------------

Wave2
-A--------------------A------------------
-------C------A-------------------------D
----------------------------------------D
------BB--------------------A------------
--A---------------------D----------------

Wave3
-A--------------------A------------------
-------C------A-------------------------D
----------------------------------------D
------BB--------------------A------------
--A---------------------D----------------

Wave7
-A--------------------A------------------
-------C----EEEEEEEEEEEEEEEEEEEE--------D
----------------------------------------D
------BB--------------------A------------
--A---------------------D----------------

InfosA
HP:10
SPD:60
DMG:60

InfosB
HP:5
SPD:90
DMG:45

InfosC
HP:20
SPD:60
DMG:60

InfosD
HP:30
SPD:45
DMG:100